{
  "Title": "FirstLevel",
  "GridXSize": 10,
  "GridYSize": 20,
  "Money": 500.0,
  "NumberOfRounds":5,
  "LevelGridArray": [
    "SRRRRRRRRRRRRRRRRWT.",
    "TTTTTTTTTTTTTTTTTRTT",
    "TTTTTTTTTTTTTTTTTRTT",
    "TWRRRRRRRRRRRRRRRWTT",
    "TRTTTTTTTTTTTTTTTTTT",
    "TRTTTTTTTTTTTTTTTTTT",
    "TWRRRRRRRRRRRRRRRWTT",
    "TTTTTTTTTTTTTTTTTRTT",
    "TWRRRRRRRRRRRRRRRWTT",
    "TRTTTTTTTTTTTTTTTTTT",
    "TWRRRRRRRRRRRRRRRRRE"
  ]
}